10 8

1111001111
1111111111
1111111111
0111111110
0011111100
0111111110
1111111111
1111001111

300