14 12

11100111100111
11111111111111
11111111111111
11111111111111
11101100110111
11111111111111
11111111111111
11101100110111
11111111111111
01111111111110
00111011011100
00010011001000

420